





                 X
               T
               X
             B  T
   TT        X  X   C
 XAXX       X      TX   DX
  X  XT   X   X    X X  X  X
X     X                T  X
       XT  X      X    X
        X             X

         T
         X